11111111111111111111111111
10000000000000000000000001
1000000000000000C000000001
100000000000C0000000000001
1000000000000000C000000001
100000000C0000000000000001
10000010111000000111111001
10P00000111111110100000001
11000000001000000000000001
10000000001000E00000000001
1000000000100000000M000001
11111111111111111111111111