11111111111111111111111111
10000000000000000000000001
1000000000000000C00E000001
100000000000C0000000000001
10000P0000000000C000000001
100000000C0000000000000001
10000010111000000111111001
10000000011111111010000001
11000000001000000000000001
10000000000100000000000001
10000000001000000000000001
11111111111111111111111111