11111111111111111111111111
10000000000000000000000001
1000000000000000C00E000001
100000000C00CCCC0000000001
10000P000C000000C000000001
100000000C0000000000000001
10000000111000000111111001
10000000011111111000000001
110000000010000CCCCC000001
1000000000010000CCC0000001
10000000001000000C00000001
11111111111111111111111111