11111111111111111111111111
1CMC00000000MMM00000000001
1MCM000000000M0000CMC00001
100000000000M0M000MEM00001
1000MCM00000000000CMC00001
100011110000MCC00000000001
100000000000CMC00000000001
10P00000011111111000000001
10000M00000000MC000000M001
11100C0000000000000000C001
10000M00000000000000000001
11111111111111111111111111