11111111111111111111111111
10000000000000000000000C01
100CMC000000000000CMC0CCC1
10001000000CCC0000MEM01111
100CMC00000CMC0000CMC00001
10000000000CCC000000000001
1000000000MCMCMC0000000001
10P0000001111111100000C001
1000CMC000100CMC10000CMC01
11100C0000000001000000C001
10000M00000000100000000001
11111111111111111111111111