1111111111111111111
100000000000000E001
1000000000000000001
1000000000000000001
10000C0C0C0C0000001
10000C0C0C0C0000001
10000C0C0C0C0000001
10000C0C11111000001
10000C0C000C0000001
10000C0C0C0C0000001
10P00C0C0C0C0000001
1111111111111111111