11111111111111111111111111
10000000000000000000000001
1000000000000000C00M00M001
100000000000C00000MEM00001
1000000000000000C00M000001
100000000C0000000000000001
10000010111000000111111001
10P00000011111111010000001
11000M00001000M0000000M001
10000000000100000000000001
10000M00001000000000000001
11111111111111111111111111